NO spidey.png
SO spidey.png
WE images.png
EA generated-9257471_1280.png

F 0,0,255
C 0,255,0

1111111111111
1000000000001
10000100N0001
10000010000001
1111111111111