NO thumb-1920-1354019 (1).xpm
SO thumb-1920-1354019 (1).xpm
WE thumb-1920-1354019 (1).xpm
EA thumb-1920-1354019 (1).xpm

F 20,100,15
C 225,30,0

1111111111111111111111111111111111     1111111111
1000000000110000000000001
11111111111111111111111111     
1111111111111111111111111111111
10110000011100000000000111111111
100100000000000000000000100000001
111111111011000001110000000000001
100000000011000001110111111111111
11110111111111011100000010001
11110111111111011101010010001
1100000011101011100000010001
10000000000000001100000010001
1000000000000N00110101001001
110000011101010111110111100111111 
111101111111101011101111010010111 
11111111111111111111111111111111111111111111